isn't: is, not
aren't: are, not
wasn't: was, not
weren't: were, not
can't: can, not
could've: could, have
couldn't: could, not
didn't: did, not
doesn't: does, not
don't: do, not
hadn't: had, not
hasn't: has, not
haven't: have, not
he'd: he, would
he'd've: he, would, have
he'll: he, will
he's: he, is
how'd: how, did
how'll: how, will
how's: how, is
I'd: I, would
I'd've: I, would, have
I'll: I, will
I'm: I, am
I've: I, have
it'd: it, would
it'd've: it, would, have
it'll: it, will
it's: it, is
let's: let, us
might've: might, have
mightn't: might, not
must've: must, have
mustn't: must, not
needn't: need, not
oughtn't: ought, not
she'd: she, would
she'd've: she, would, have
she'll: she, will
she's: she, is
should've: should, have
shouldn't: should, not
that'll: that, will
that's: that, is
there'd: there, would
there'll: there, will
there'd've: there, would, have
there're: there, are
there's: there, is
they'd: they, would
they'd've: they, would, have
they'll: they, will
they're: they, are
they've: they, have
we'd: we, would
we'd've: we, would, have
we'll: we, will
we're: we, are
we've: we, have
what'll: what, will
what're: what, are
what's: what, is
what've: what, have
when's: when, is
where'd: where, did
where's: where, is
who'd: who, would
who'll: who, will
who's: who, is
why's: why, is
won't: will, not
would've: would, have
wouldn't: would, not
you'd: you, would
you'd've: you, would, have
you'll: you, will
you're: you, are
you've: you, have